0110000110
0000110010
1110110110
0000010010
0101011000
0101000010
0111100010
0000101111
1000000001
1001100101