0000011101
1011000101
0001010000
1100011110
0101001100
0101000001
0101011100
0101000010
0001011000
1011000011