0110000001
0000111101
1110001001
0001001000
0010010010
0100100010
0011001010
0100010010
0111111110
0000000000